SO textures/so_wall.xpm
WE textures/we_wall.xpm
EA textures/ea_wall.xpm
NO textures/no_wall.xpm

F 200, 0, 0
C 252, 140, 3

11111111111111111111111111111111
11111100011111111100011111111111
11110000000111110000000111111111
11000000000001000000000001111111
10000000000000000000000000111111
11000000000000000000000001111111
11100000000000000000000011111111
11110000000000000000000111111111
11111000000000000000001111111111
11111110000000000000111111111111
1111111110000N000011111111111111
11111111111000001111111111111111
11111111111100111111111111111111
11111111111111111111111111111111
    1               1
    1               1
    1               1
    11111111111111111
    10000000000000001
    10000000000000001
    11111111111111111