SO textures/so_wall.xpm
WE textures/we_wall.xpm
EA textures/ea_wall.xpm
NO textures/no_wall.xpm

F 73, 122, 43
C 123, 192, 209

111111111111111111111111111111111
100000000000000010000000000000001
101111111111111010111111111111101
101000000000001010100000000000101
101001111111001010101111111110101
101001000001001000100000000010101
10100100E000001111100111111010101
101001000001000000000000000010101
101001111111001111111110111110101
101000000000001000000000000000101
101111111111111010101010101010101
100000000000000010101010101010101
101110111011101110101010101010101
101000000000000000000000000000101
101011111111111111111111111110101
101000000000000000000000000000001
111111111111111111101111111111111
    101           101
    101           101
    101           101
    10111111111111101
    10000000000000001
    10000000000000001
    11111111111111111