SO textures/so_wall.xpm
WE textures/we_wall.xpm
EA textures/ea_wall.xpm
NO textures/no_wall.xpm

F 222, 91, 180
C 119, 34, 153

11111111111
11111011111
11110001111
11100000111
11000000011
10001010001
11000000011       11111
11100000111111111110001
11110001111       11111
11111S11111
11111111111