SO textures/so_wall.xpm
WE textures/we_wall.xpm
EA textures/ea_wall.xpm
NO textures/no_wall.xpm

F 162, 0, 0
C 118, 28, 28


11111111111
11101110111
11000100011
10000000001
11000000011       11111
11100000111111111110001
11110001111       11111
11111S11111
11111111111