SO textures/so_wall.xpm
WE textures/we_wall.xpm
EA textures/ea_wall.xpm
NO textures/no_wall.xpm

F 9, 101, 53
C 9, 11, 53

111111111111111111111
111111100000111111111
111111101010111111111
101000001010000000001
101010101011111110001
100010100010000010001
111110101111101011101
100000101000101000001
101111101011101111111
101000001010100000101
101011111010111110101
101000001010100010101
101110101010101010101
100000101010001010001            111111111
111111101011111011101            110000001
100000001000100010001            100000001
101110101110101110111            111001111
101000100000100010101            111111111
101011111111111010101
100010000000000010001
101010111011111111101
1N1000001000000000001
111111111111111111111