SO textures/so_wall.xpm
WE textures/we_wall.xpm
EA textures/ea_wall.xpm
NO textures/no_wall.xpm

F 224, 224, 224
C 153, 204, 255

111111111111111
100000000000001 
100000000000001
100000000000001
100000000000001
100000000000001                  11111111111111111111111111
100000100000001                 1111111111110000000111111111
100000000000001                  11111111111111111111111111
100000000000001
100000000000001
100000000000001
1N0000000000001
111111111111111